#########################################################################################################################
#                       #  #        #     #        #           #           #     #              #  #  #  #  #     #     #
#######  #############  #  ####  #######  ####  ####  #  #######  ####  #######  #############  #  #  #  #  ####  ####  #
#        #     #           #     #  #     #     #     #           #           #           #           #           #     #
#  #######  #######  #  #  #  ####  ####  #  ##########  ##########  #  #  ####  ####  #  ####  ####  #  #  ##########  #
#           #  #     #  #     #  #              #  #        #  #  #  #  #  #     #     #  #  #     #  #  #  #  #        #
####  #  ####  #  ####  #  ####  #  ####  #######  #  #  #  #  #  ####  #  ####  #  ####  #  #######  ####  #  #  ####  #
#  #  #     #     #  #  #           #     #           #  #     #        #     #  #  #              #           #     #  #
#  #######  #######  ####  #  ####  #  ####  ####  #  #############  #  #############  ##########  ####  #######  ####  #
#        #     #     #  #  #     #  #           #  #  #           #  #  #           #     #     #        #  #  #  #  #  #
#  #############  ####  #  #  #  #  #  #######  #######  ####  #  ####  ####  ################  #  #  #  #  #  ####  #  #
#     #  #           #     #  #  #  #     #  #        #     #  #     #     #                 #     #  #  #              #
#  #  #  #  ####  ####  #############  ####  ####  ####  ######################  #######  ####  #  #  ####  #######  ####
#  #        #  #        #        #     #  #           #     #  #        #  #        #           #  #     #     #     #  #
#############  #  #  ####  #############  #  #  #  #  ####  #  #  #######  #  #  #  #  #############  #  ##########  #  #
#  #              #  #        #     #     #  #  #  #  #                 #  #  #  #  #  #  #           #     #           #
#  #  #############  #  #  #######  #  #  ####  #  ####  #######  #  #  #  #  #  #######  #######  #  #  ####  ####  #  #
#     #     #     #  #  #  #        #  #  #     #  #        #  #  #  #  #     #        #     #     #  #  #  #     #  #  #
#######  ####  ####  #  ##########  #  ##########  ##########  #  #######  ################  #######  ####  ##########  #
#        #     #           #                 #  #        #           #        #              #  #  #     #  #           #
#  #  ####  ##########  #  ####  #  ##########  ####  #  ####  #  #######  #  #  ##########  #  #  #  ####  ##########  #
#  #  #     #           #     #  #  #        #  #     #  #  #  #        #  #     #     #     #  #              #     #  #
#  #  ####  ####  ####  ####  ####  ####  #  #  #  #  ####  #  #  ####  #  #######  #  ####  #  #######  #######  #  #  #
#  #     #        #  #  #     #        #  #  #  #  #     #     #  #  #     #     #  #     #  #  #     #        #  #     #
#  #######  ####  #  #######  #######  ####  #  #  #######  #######  #  #  ####  #  ####  ####  #  #  ####  ####  #  ####
#           #           #        #  #                          #        #     #        #  #     #  #              #  #  #
#  #######  ####  ################  #  #  ####  ####  ####  ####  ####  ####  #  #  ####  #  ####  #############  ####  #
#  #  #  #  #  #  #                 #  #     #     #  #        #  #     #        #  #  #  #           #     #           #
####  #  #  #  #######  #######  #############  ####  ####  ####  ####  #############  #######  ##########  ##########  #
#  #        #     #     #                 #  #     #     #  #  #  #     #        #        #     #              #        #
#  #  #  #  #  #  #  ####  ##########  #  #  #  ####  ####  #  ####  #  ####  #  ####  ####  ####  ####  ####  #  #######
#     #  #  #  #        #     #        #  #  #  #     #        #     #  #     #  #           #     #  #  #     #     #  #
#  #############  ##########  ##########  #  ##########  ####  #############  #######  ##########  #  #  #  #  ####  #  #
#     #  #        #  #  #        #     #  #           #     #     #  #     #     #        #  #        #  #  #     #     #
#  ####  ####  ####  #  #  #######  ####  #  ####  #  #############  #  ####  #  #  ####  #  ####  ###################  #
#  #     #              #     #  #  #  #     #  #  #        #              #  #  #  #        #     #  #              #  #
#  #  #  #  #  ##########  #  #  #  #  #  ####  #  ####  #  #  #######  #######  #  #######  ####  #  #  #  #  #  #######
#     #     #     #  #  #  #        #  #     #     #     #  #     #  #              #  #     #  #        #  #  #     #  #
####  ##########  #  #  #  ####  #  #  #######  ####  ####  ####  #  #  #############  #  #  #  ####  #  ##########  #  #
#     #              #     #     #     #           #     #  #     #           #           #           #        #        #
######################################################################################################################  #
