#######################################################################################################################################################
#     #        #     #  #  #  #           #  #     #           #           #  #           #     #  #     #                 #     #     #     #  #     #
#  #  ####  #  #  ####  #  #  #  #  #######  #  ##########  ####  #  ####  #  ####  #  ####  ####  ####  #######  #  #######  ####  #  #  ####  #  #  #
#  #        #  #           #     #           #  #              #  #  #           #  #              #  #     #     #  #           #  #     #        #  #
#######  #  ####  ####  ##########  ####  ####  #  ####  ##########  #  ####  ####  ####  #######  #  #  ##########  #  #  #######  #  #  #  ####  ####
#        #  #  #  #  #                 #              #     #     #  #     #     #     #  #  #              #  #     #  #           #  #  #  #        #
####  #  #  #  #  #  #  ####  ##########  ####  ####  ##########  #######  #  #############  #  #######  ####  #  #  ####  #######  #  ####  #######  #
#     #  #  #  #  #  #     #  #     #  #     #     #        #           #  #           #     #  #  #              #     #     #  #  #  #  #  #     #  #
####  ####  #  #  #  ##########  ####  #######  ##########  #######  #  #  ##########  #  ####  #  #############  #  #  #  ####  #  ####  ####  ####  #
#        #  #  #     #     #                             #           #  #  #  #     #           #  #              #  #     #              #           #
#######  ####  #  ####  ##########  #######  ##########  #######  #######  #  #  #######  #######  ####  #######  #  #######  #  #######  ##########  #
#  #     #     #     #  #        #     #     #     #     #  #     #     #        #  #           #        #     #  #     #  #  #  #        #  #        #
#  ####  #  ####  ####  #  #  ####  #######  #  ####  ####  #  #######  #  #######  ####  #  #  #######  ####  ####  ####  #  #######  #  #  ####  #  #
#        #        #  #  #  #     #     #     #              #  #  #           #           #  #  #        #        #        #        #  #        #  #  #
#######  #  #  ####  #  #######  #######  ##########  ####  ####  #  ####  #############  #######  #######  ####  #  ####  #########################  #
#     #     #  #        #     #        #        #  #  #        #        #  #  #           #  #     #  #  #  #     #  #  #     #              #     #  #
#  #######  #######  ####  #  #  #  #  ####  ####  ##########  #  ##########  ####  #  #  #  ####  #  #  #  #  #######  ####  #############  #  ####  #
#                 #  #  #  #     #  #     #        #  #     #  #  #     #     #     #  #  #     #     #     #  #              #     #                 #
#######  ##########  #  #  #######  ####  ####  #  #  #  ####  ####  #  ####  #############  ####  #  #######  ####  ##########  #  #  #  ####  #  #  #
#           #              #     #     #     #  #  #        #  #     #  #                    #  #  #     #     #        #     #  #     #     #  #  #  #
####  #  #######  #############  #  #  #  #######  #######  ##########  #  ####  #  #######  #  ##########  #######  ####  ##########  ####  #######  #
#     #     #        #  #  #        #  #  #           #  #  #     #           #  #  #  #        #     #           #              #  #     #        #  #
##########  ####  ####  #  #  ####  #######  #  ####  #  #  ####  #############  #  #  ####  #######  #  ##########  ####  #######  ####  #######  #  #
#  #  #  #  #     #     #  #     #        #  #  #                    #           #  #  #  #     #                       #  #                 #  #  #  #
#  #  #  #  ####  #  ####  #######  #  ####  ####  ####  #  ####  ####  #######  ####  #  ####  ###################  #############  #  #######  #######
#     #  #        #  #  #        #  #     #     #     #  #     #              #     #        #        #  #        #  #  #     #     #        #  #  #  #
#  ####  #  #  ####  #  #  #######  ####  ####  #  #######  #  ####  #  ##########  #  #  ####  ####  #  #  #######  #  ####  #  ####  ####  #  #  #  #
#  #  #  #  #     #        #        #     #  #  #  #     #  #  #  #  #  #  #  #  #     #  #        #  #           #                 #  #        #     #
#  #  #  #  ####  ####  #  ####  #  #######  #  #######  #  ####  #######  #  #  #  #  #  #######  #  #######  #######  #############  #############  #
#              #  #  #  #  #     #     #              #  #  #        #        #     #  #     #  #  #                             #  #                 #
##########  #  #  #  #  #  #  #  #  #  ####  #  #  ####  #  #######  ####  #######  #######  #  ################  ####  #  #######  #############  ####
#           #  #     #  #     #  #  #  #     #  #     #           #                       #                    #     #  #           #                 
####################################################################################################################################################  
